AND	AH N D
AND(2)	AE N D
BEDROOM	B EH D R UW M
BRING	B R IH NG
CH	S IY
COFFEE	K AA F IY
COFFEE(2)	K AO F IY
DINNER	D IH N ER
GO	G OW
GRASP	G R AE S P
HALLWAY	HH AO L W EY
HUH	HH AH
HUM	HH AH M
IT	IH T
KITCHEN	K IH CH AH N
LIVING	L IH V IH NG
ME	M IY
MILK	M IH L K
MM	EH M
NAA	N AA
PRINGLES	P R IH N G AH L Z
PU	P UW
ROOM	R UW M
S	EH S
SH	EH S
SS	EH S
TABLE	T EY B AH L
THE	DH AH
THE(2)	DH IY
TO	T UW
TO(2)	T IH
TO(3)	T AH
TU	T UW
TV	T IY V IY
TV(2)	T EH L AH V IH ZH AH N
WA	W AA
